%%%%%%%%%%%%%%
%%%%%%%%%%%%%%
%%%%%%%%%%%%%%
%%%%%%%%%%%%%%
%%%%....P%%%%%
%%%%.%%% %%%%%
%%%%.%%% %%%%%
%%%%..G  %%%%%
%%%%%%%%%%%%%%
% %%%%%%%%%%%%
%%%%%%%%%%%%%%
