%%%%%%%%%%%%%%
%%%%%%%%%%%%%%
%%%%%%G%%%%%%%
%%%%%%.%%%%%%%
%%%%%%.%%%%%%%
%%%%%%.%%%%%%%
%%%%%%P%%%%%%%
%%%%%%%%%%%%%%
%%%%%%%%%%%%%%
% %%%%%%%%%%%%
%%%%%%%%%%%%%%
