%%%%%%%%%%%%%%
%............%
%.  %     % .%
%.  %     % .%
%.  %     % .%
%.     %    .%
%P          G%
%%%%%%%%%%%%%%
%%%%%%%%%%%%%%
% %%%%%%%%%%%%
%%%%%%%%%%%%%%
