%%%%%%%%%%%%%%
%%%%%%%%%%%%%%
%%%%%%%%%%%%%%
%%%%%%%%%%%%%%
%%%%.....%%%%%
%%%%.%%%.%%%%%
%%%%.%%%G%%%%%
%%%%.%%% %%%%%
%%%%P    %%%%%
% %%%%%%%%%%%%
%%%%%%%%%%%%%%
