%%%%%%%%%%%%%%
%%%%%%%%%%%%%%
%%%%%%P%%%%%%%
%%%%%%.%%%%%%%
%%%%%%.%%%%%%%
%%%%%%.%%%%%%%
%%%%%%G%%%%%%%
%%%%%%%%%%%%%%
%%%%%%%%%%%%%%
% %%%%%%%%%%%%
%%%%%%%%%%%%%%
