%%%%%%%%%%%%%%
%%%%%%%%%%%%%%
%%%%%%%%%%%%%%
%%%%%%%%%%%%%%
%%%%.....%%%%%
%%%%.%%%.%%%%%
%%%%G%%%.%%%%%
%%%% %%%.%%%%%
%%%%    P%%%%%
% %%%%%%%%%%%%
%%%%%%%%%%%%%%
