%%%%%%%%%%%%%%
%%%%%%%%%%%%%%
%%%%%%.%%%%%%%
%%%%%%.%%%%%%%
%%%%%%P%%%%%%%
%%%%%%G%%%%%%%
%%%%%%%%%%%%%%
%%%%%%%%%%%%%%
% %%%%%%%%%%%%
%%%%%%%%%%%%%%
