%%%%%%%%%%%%%%
%%%%%%%%%%%%%%
%%%%%%.%%%%%%%
%%%%%%.%%%%%%%
%%%%%GP%%%%%%%
%%%%%%%%%%%%%%
%%%%%%%%%%%%%%
%%%%%%%%%%%%%%
% %%%%%%%%%%%%
%%%%%%%%%%%%%%
