%%%%%%%%%%%%%%
%%%%%%%%%%%%%%
%%%%%%.%%%%%%%
%%%%%%.%%%%%%%
%%%%%%PG%%%%%%
%%%%%%%%%%%%%%
%%%%%%%%%%%%%%
%%%%%%%%%%%%%%
% %%%%%%%%%%%%
%%%%%%%%%%%%%%
