%%%%%%%%%%%%%%%%%%%%
%                  %
%                  %
%   %  G %%%%  G   %
%   %    %         %
%   %    %         %
%                . %
%        %   %     %
%        %   %     %
%    %%%%%   %     %
%                  %
%        P         %
%                  %
%%%%%%%%%%%%%%%%%%%%
% % % % %%%%%%%%%%%%
%%%%%%%%%%%%%%%%%%%%
