%%%%%%%%%%%%%%
%%%%%%%%%%%%%%
%%%%%GP%%%%%%%
%%%%%%.%%%%%%%
%%%%%%.%%%%%%%
%%%%%%%%%%%%%%
%%%%%%%%%%%%%%
% %%%%%%%%%%%%
%%%%%%%%%%%%%%
