%%%%%%%%%%%%%%
%%%%%%%%%%%%%%
%%%%%%%%%%%%%%
%%%%%%%%%%%%%%
%%%%    P%%%%%
%%%% %%%.%%%%%
%%%%G%%%.%%%%%
%%%%.%%%.%%%%%
%%%%.....%%%%%
% %%%%%%%%%%%%
%%%%%%%%%%%%%%
