%%%%%%%%%%%%%%
%G          P%
%.  %     % .%
%.  %     % .%
%.  %     % .%
%..    %   ..%
% .......... %
%%%%%%%%%%%%%%
%%%%%%%%%%%%%%
% %%%%%%%%%%%%
%%%%%%%%%%%%%%
