%%%%%%%%%%%%%%
%      P     %
%   %  .  %  %
%   %  .  %  %
%   %  . .%  %
%      % .   %
%        ...G%
%%%%%%%%%%%%%%
%%%%%%%%%%%%%%
% %%%%%%%%%%%%
%%%%%%%%%%%%%%
