%%%%%%%%%%%%%%
%%%%%%G%%%%%%%
%%%%%%P%%%%%%%
%%%%%%.%%%%%%%
%%%%%%.%%%%%%%
%%%%%%%%%%%%%%
%%%%%%%%%%%%%%
% %%%%%%%%%%%%
%%%%%%%%%%%%%%
