%%%%%%%%%%%%%%
%%%%%%%%%%%%%%
%%%%%%%%%%%%%%
%%%%%%%%%%%%%%
%%%%..G  %%%%%
%%%%.%%% %%%%%
%%%%.%%% %%%%%
%%%%....P%%%%%
%%%%%%%%%%%%%%
% %%%%%%%%%%%%
%%%%%%%%%%%%%%
