%%%%%%%%%%%%%%
%%%%%%%%%%%%%%
%%%%%%PG%%%%%%
%%%%%%.%%%%%%%
%%%%%%.%%%%%%%
%%%%%%%%%%%%%%
%%%%%%%%%%%%%%
% %%%%%%%%%%%%
%%%%%%%%%%%%%%
