%%%%%%%%%%%%%%
%%%%%%%%%%%%%%
%%%%%%%%%%%%%%
%%%%%%%%%%%%%%
%%%%P    %%%%%
%%%%.%%% %%%%%
%%%%.%%%G%%%%%
%%%%.%%%.%%%%%
%%%%.....%%%%%
% %%%%%%%%%%%%
%%%%%%%%%%%%%%
