%%%%%%%%%%%%%%
%G   P       %
%            %
%            %
%            %
%            %
%            %
%            %
%%%%%%%%%%%%%%
% %%%%%%%%%%%%
%%%%%%%%%%%%%%
